**********
*X*X*XX*X*
*****XX*X*
X*XX******
*****X*XX*
*XX*X***XX
**X**XX***
X*XX**X*X*
X**XXXX*X*
XX******X*