*XX**X*XXXX*X****X*XX***X****X*X*XX********X*****X*X*XX***X*************X*X***XX*******XX******X***X
**XX****XX****XX*X****X*X*XX*X****X*X*X*XX*X*XXXXX******X*XXXXXXXX*XX*X***XX*XX**XXX*X*X**XX*X*XXX**
X*XX*XX**X*XXXXX*XXX*XX*XXX**X*XX***X*XXX**X*******XX*X*X**X***XX**X**X*X**X****XX*X*XXX*XX**X**XXX*
**X**XXX*******X**X**XX*****XX*XXXXXX*XX**XXX*XXXXXXX*X*XX***X**XX*X*XXXXX*XXX*XX****X***XX*XXX*X***
*XX*XX*XXX*XXX*XX*XX**XXXXX*XX*X**X***X**XXX*****XX***XXXXXXXXX**XXX*X*XX***XX**XXXXXX*XXX**X*X*XXX*
**X******XXX***X**XXX***XX***X***XX*XXXX***XXXXX**X*XXXX*****XXX*X***X*X**X****XXX******X**XX***X***
X*XXXX*XXX***X*X*XX*X*X*X**X*XX*XX**X**X*X*****XX*X******XX*XX***XX*XX***XXXXXXX*X*XXXXXX*XXX*XXX*XX
***XX**X***XXXXX*X****X*XXXXXXX*X**XX*XX*XXXXX*X**XXXXXXXXX**XX*XX**X**XXX*X***X*X*X***XX*X*X*XX****
XX**XX*X*XXXX*X**X*X*XX***X*X***X*XX**XXXX***X*XX*X*X***X*XX**X****XX*XX*X*X*X*X***X*XXX**X****XXXX*
*XX**XXX**X*X*X*XXXXXXXXX***X*XXX*XXX**XX**X*X**X*X***X*X**XX*XXXXXXX******X*X***XXX*X***XXXXX**X***
*XXX***XX*X********X***XXXX*****X**XXX**X*XXXXX*X*X*X*X*XX**X*X***X*XX*XXXXX*XXXXXX**X*XXX*X*XX***X*
*X*XXX**X*X*XXXXXX***X****XXXXX*XX***XX*****XX**X*X*X*X*XXX*X***X*X*X***X****X****XX*X*X*****XXXXXX*
****XXX*X*XXX***XXXXXXXXX***XX***XXX*XXXXXX**X*XX*XXX*X*****X*XXX*X***X*X*XXXXX*X*X**X*XXX*X*****X**
*XXXX***X*****X**XX*****XXX**XXX*X*X*X***XXX*X*X***X**XXXXXXX*X***X*XXXXX*X*****X*X*XX**X**XXXXXXX*X
**X***XXXXXXXXXX****XXX***XX**XX*X*X***X**XX***XXX*XX***X***X*X*XXX*XX*X**XX*XXXX***XXX*XX****XX****
X***XXXX*X****XXX*XXX*XX*XXXX*X**X*XXXXXX**XX*XX*X**XX*XX*X*XXX*XX***X*X*XX**X**XX*XX*X**XXXX**X*XXX
**XXX******XX***X**XX**X**X*X*XX*X***X**XX*X***X*XX**X*X**X**XX**XXX***X****XXX*******XX****XX******
*XX*XXX*XXXXXXX*XX****XXX*X***X****X*X*XXX*XXX*X**XX*X*X*XXX**XX**XXXX*XXXXXX*XXXXXXX*XXXXX*XX*XXXX*
**X*****X*****X**XXXXXX***X*XXXXXX*X*****X*X***X*XXX*X*X*XXXX*XXX*X****X*X*X***XX***X***X*X**XXX****
X***XXXXXXXX*XXX*X***XXX*XX**X*X*X*XXXXXXX*X*X*X*******X**XXX*****XXXXXX*****X*X**X*XXX***XX**XX*XX*
XX*XX*********XX*X*X**X**XXX*X*X***X*****X*X*XXXXXXXXXXXX**X**X*X**XX****X*X*X***XX**XXXX**XX**XXX**
XXXX**XXXX*X*XX**X*XX***XX*X*X***XXX*X*X***X**XXX***X***XX*XXXXXX*XX**XXXXXXXX*XXXXX**X*XX*XXX***XX*
XXX**XX****XXX**XX**XXXXX****X*XXX*X*XXXXXXXX**X**X*X*X*XX*XX***XXX**XX***X****X***XX****X**XXXX**X*
XX**XXXX*X**X**XXXX*****XXX*XX*XX**X*XX*X*XXXX***XX*X*X**X**X*X*****XX**X***XXXX*X*XXXXXXXX*X**XX*X*
X**XX****X*XX*XX**X*XXX**X**X***XX*X**X****XXXXXXXX***XX*XX*X*XXXXXXXX*XXXXXXX***X*****XX*X*XX*XX*X*
**XXX*XX*XXX***XX*X***XX*X*XX*X**X*XX*X*XX**X*****XXXXX**XX*X**XX*XX*X**X******X*XXXXX*X**X*X**X**X*
*XX*X**XXX***XXXX*XXX*X**X*XXXXX***XX*X**XX***XXXXX*X***XX**XX**X****XX***X*XXXXXX*******XX*XX*X*XX*
**X*XX*****XXX*X****X*X*XX***XX**XXX**XX**XXX*****X***XXX**XXXX*XXX*XXXXXXXXX***XXX*XX*XXX**X**X*XX*
X*X**XXXXXXX***X*XXXX*X*XXXX**XXXX***XXXX*X*XXXXX***XXX***XX**X**XX****X***XX*X***X*X***X**XXX*X**X*
**XX*XX***X**X****X***X*X*XXX*XX***XXX****X*****XXXXX***X****XXX**XXXX***X**X*XXX*X*XXXXX*XX***XX*XX
*XX**X**X***XXX*XXX*XXX*X********X*X***XXXXXXXX***X***XXXXXX*XXXX***X**X*XX*X**X**X***X***X**X**X**X
*XXX***XXX*XXX***XX*XX**XXXXX*XX*XXXXX*X******X*X*XXX*X*X*X***X*XXX*XXXX**X*XX*X*XX*X*X*XXX*XXX*XX**
**X**XXX*X*X***XXX**X**XX***XXX**X***X***XXXX***X***X*X***X*X*****X***XXXXX**X*X**X*X***X*X*X*X*XXX*
X*X*XX***X*XXXXXX**XX*XX**X***XX*X*X*XXX*X*XXXX*X*X***X*XXX*XX*XXXXXX**X****XX*XX*X*XXXXX***X*****X*
**X****X*X*X******XX**X**XXXX**X*X*X**XXXX******XXXXXXX**XX**XXX***XXX*X*XX**X**X*X*******X*XXXXXXX*
*XXXXXXX*X***XXXXXX**XX*XX**XX*XXX*XX***X**XXXXXXX***XXX****XX***X********XXXXX*X*XXX*XXXXX**X***X**
*******XXXXX**X***XX*XX**XX**X*X****XXX*XXXXX****X*X**X**X*XX**X*X*XXXXXXXX***X*X*XX**X***XX*X*X***X
XXXXXX*****XX*X*X*X***XX**X*XX***XXXX***X*****XX*X*XX***XXXX**XXXXXX******X*X***X**XXXX*X*XX*X*X*X**
X****XXXXX**XXX*X*XXX*XXX***XXXXXX*XX*XXX*XXX*XX*X*XXXXXXX***XX***XXX*XXX*X*XXXXXX***X**X**XXX*X*XX*
**XX**XX*XX**X**X***X***XX*XX*******X**X**XX**X**X**X****XX*XX**X***X*X*X***X****XXX***XXX*XX**XXX**
*XXXX****XXX***XXXX*XXX*****X*XXXXX*XX***XX**XX*XXX*X*XX*X***X*XXXX***X*XXXXX*XX*X*XXXXXX***X*XXX**X
***XXXXX***XXXXX**X**X**XXX*XXX*****XXXXXX**XX**X***X**XXX*XXX*X*XXXXXX****XX*XX****X***XXX*X***XXXX
*X*****XX*XX*X***XXX*X*XX*X**XXX*XX*X***X**XX**XX*XXXX**X****X*X***XX*XX*X**X**XX*XXX*X*****X*X***XX
*XXXX*XXXXX****XXX*X*XXX**XX**X***XXX*X*XXXX**XX*******XX*XXXX*X*X****X**XX*XXXXX**X**XXXXXXXXXXX***
*X**X**X*X**XX*****X**X**XXXX*X*X**X**X*XX***XXXXXXXXXXXX***X**X*XX*X*X*XX********XX*XXX***X******X*
***XXX*****XXXXXX*XXX*X*XXX***X*X*XX*XX****XXX*X***X******XXX*XX*X**X***XXXXXXXXXXX**X***X*X*XXXXXX*
XX**XXX*XXXXX*****XX**X*****X*XXX**X*XXX*X**XX***X***XXXXXX***X**X*XXXXXX***X*****X*XX*XXX***X****X*
*XX*X*XXX***XXX*X**X*XXX*X*XX**XXX*X***XXXX**XX*XXXXXXX*****XXX*XX**X*****X*X*XX*XX*X**X*XXXXXXX*XX*
*XX*X**X**X*X***X*XX***XXXXXXX*****X*X****XX**X****X****XXXXX*X*XXX*X*XXX*X****X**X***XX***X******X*
****XX***XX*X*XXX**XXX****X*XXXXXXXX*XXX*XXXXXXXX*XX*XXXX*X***X***X***XX**X*XXXXX*XXXXX**X***XXXXXX*
*XXXXXX*XX**X***XX***X*XX*X*******X***X**X****XX**X**X******X*XXXXXXXXX**XX***XX**X*****XX*XXX******
*X*X*XX*XX*XXX*XXXXX*XXX**XXXXX*X*XXX*X*XX*X*XX**XX*XX*XXX*XX*XX******XXXX**XXX**XX*XXXXX***X**XXXXX
***X*X**X***XX*XX*****X**XX*****X**X**X****X****XXX*XXXX***X*****XX*X****X*XX***XX***X****X*X*XX*X**
*X*X***XX*XXX**X**XXXXX*XX**XXXXXX*X*XXXX*XXXXXXXX**X****X*X*X*XXXXXXXXX*XXXX*XXX**X*X*XX*XXX*X****X
XX*XX*XXXXX***XX*XX**X***XX*X****X*XXXXX**X****X*X*XX*XXXX*XXXXX*****X********XX**XXXX**XXX***XXXX**
X**X**X**X**XXXX*X**XX*XXX****XX*X**XXX**XX*XX***X**X***XXXXX****XXX*XXXXXXXX**X*XXXX**XXX**XXXX***X
**XXX***XX*XX**X***XXX**X**XXXX**XX**X**XXXXXXX*XXX*X*X*X*****XXXX*X**X****XX*XX*XXX**XX***XX**X*XXX
*XX*XXX**X*X**XXXX***XX*XXXX****XXXX*XX*******X*X*X*XXX*X*XXXXX****XX***XX**XXX***X**XXX*XXXXX*X****
*X******XX*XX****X*X**X******XXXX*XX**XXXXXXX***X*X***X*X**XX***XXXXXXX*XXX*XX**XXX*XX***XX******XX*
*XXXX*X**X**XX*X***XX*XX*XXXXX*X***XX***X***XXX*X*XXX*X*XX*X**X**XX***XXX***X**XXX**X**X*X**XXXXXX**
***X**XX*XX**XXXXXXXXXXXXX*****XXX**XXX*X*X*****X**X**X******XXX*X**X***X*X*X*XX*X*XX*XXXXXXX***XXX*
XX***XX**XXX***X*****X*XX**X*X*****XX*X*XXXXXXX***XX*XX*XXXX**XXXX*XXXX***X*X*X**X****X*X*****X**X**
*XXXXXX*XX*XXX***XXX****X*XXXX*XXXXX****XX****X*X**X**XXX*X**XX****X**XXXXX*X*XX*XXXXXX*X*X*XXXX*XX*
*X***X**X****XXXXX*XXXX******XXX*****XXXX**XX*X*XX*XX***X***XX**XXXXX*******X****X*X**X*X*X*X**X****
*X*X*X*XXXXX*X*X*X****XXXXXX***X*XXXXX****XXX*X*XXXXXXX*XXX*X**XX*X*XXX*XX*XXXXX***XX***X*X*XX*X*XX*
***X*X*X*X*****X***XX**XX**XXX***X*****X*XX*X*XXX*****X*XX**X*XX*****X***XXX***XXX*X**X***X*X**X**XX
*XXX*X*X***X*XXX*X**XX*X**XX*XXXXXXXXX*X*XX***XX**XXX*X**XX*X**XXXXX***XXX***X*XX**X*XXXXXX*X*XXX**X
XX***X*XX*XXXX***XX*XX***XXX*********X*X*X**XXX**XXX**XX**X*XX*X***XXXXX***XXX****XX****XX**X***XX**
***X*X**X***X**X**XXX**X***X*XXXXX*X*XXX*X*XX***XX***XXXX*XXX****X***X***XXX*XXXXXXXXXX*X**XXX*XXX*X
X*XX*XX*XXX***XX*XX***XXXX*XXX***X*X**X**X*XXX*XX**XXX*****XX*XXXXX*XX*XXX******XX*X****X*XX***X*X**
**XX*XX**XXX*XXXXX**XXX****X***X***XX***XX**XX**XX*X***XXX*X****X*X*XX***XXXX*X****XXX*XX*XX*X***XX*
X*X***XX***XXX*****XX***XXXX*XXXXXXXXXXXXXX**XX*X**X*XXXX**XXXX*X*X**XXX****XXXX*X***X*X**X**X*X****
X*X*X**XXX**XXXXX*XXX*XXX*****X***XX*XX***XX****X*XX**X***XX**X*X*XX**XXXXX*X****XXX*X*X*XX*XXXXXX*X
**X*XX***XX**XX***XX**X*XXXXX*X*X**X*X**X*XXXXXXX*XXX*X*XXX**XX*X**XX*****X*XX*XXX*X*X*X**XXX****XXX
*XXXXXXX*XXX**X*XXX**XX****XX*X*XX*****XX*X***X*X***XXX**XXX**X***XXXXXX*XX****X*X***X*XX*X***XX**X*
****X*XX***XX***X*X*XXXX*X**X*X**XXX*X**XXX*X***XXX**XXX**XXX*XXX***X**X*XXXXXXX*X*XXXXX**X*XXXXX***
XXX*X**XXX*XXXXXX*X**X***XX***XX***X*XX**X**X*X**XXX**XXX*X*X*X*XXX***XX*X*****X***X***X*XX*X*X*XXX*
****XX***X*X******XX*X*XXXXXXXXXX*XX**XXXX*XX*XX***XX***X*X*******XXX*X**X*X*X*X*XXX*X*X*X**X*X*****
*XXXXXX*XX*XXXX*X*X**X****X*****X**XX***X***XXXXXX**X*X***X*XXXX*XXX**X*XX*X*XXX*XX**X*X*X*XX*X*XXX*
****XX***X*X****X*X*XX*XX*X*XXXXXX**XX*XX*XXX***X**XXXXXXXX*X****X***XX**X*X***X**X*XX***X*X**X*X***
XXX*X**X***X*XXXX*X**XXXX*X****X*XX*XX****X***X***XX*XX*****XXXXXX*XXXXX***XXX*XX*X*XXX*XX*XX*X*XX*X
****XX*XXXXX***XX*XX****X*XXXX*******X*XXXX*XXXXX*XX****XX*XX****X*X***XXXXX***X**X**XX**X**X*X**XXX
X*XXX**X*X***X*X**XXXXX*X****XXX*X*XXXXX****X*X****XX*XXXX*X**X*XX***X*X***X*X*X*XXX**XX*XX***XX**X*
X*XX**XX***XXX*X*XX*X*X*XX*X***XXXXXX****XX*X***XX*X**X**X*X*XX**XXXXX*XXX*X*X*X**XXX**X**XXX**XX***
**X**XXXXX*X***X****X*X*X**X*X**X*****XX*XXXXXXXX****XXX***X**XX*****X***X*X*X*XX**XXX*XXXX*XX**XX*X
*XX*XXX*X**X*X*X*XX*X*X*XXXXXXX*X*X*XXX***XX****XXXXXX*XX*XXX**XXXXX*XXX*X*X*X*XXX*X*X***X**XX*XX***
*XX*X***XXXX*XXXXX****X*****X*X*X*X**XXXXXX**XX**X***X*X****XX*X*X*X***X***X*X***X***XXX***XX***X*XX
*X****X**X***X***XXX*XXXXXX*X***X*XX***X****XXXX*X*X***XXXX*XX*X***XX*XXXX*X*XXXXXXX***XX*XX**X*X***
*XXXXXXX*XX*XX*X***XXX****X*X*XXXXX**X***XXXX**X***XXX**X****X*XX*XX****X**X******XXXX**X*XX*XX*XX*X
******XX*XX**X*X*X**X**XX*X*X*X**X**XXXXXX**X*XXXXXX*XX*XX*XXX*XX**XXXX***XXXXXXX*X**XX*X****XXXX***
*XXX*XX***XX*X*XXXX*X*XX**X***XX*X*XXX**XXX***XX*XX***X**X***X**XX*X**XXXXX**X****XX*X**X*XX*X****X*
***X**XXX**X*X**X*X***XXX*XXXXXX*X***XX*****X****X**X*XX*X*XXXX**X***XXX****XX*XX****X*XXXX**X*XXXXX
XX*XX**XXX***XX***XXXXX****X*XX**X*X**XXX*XXXXXX*X*XX*XX*X**XXXX*X*XXXX**XX**X*XXX*XXX****XXXX**X***
****XX*X*X*X**X*XXXX****XX***X**XXXXX**XX*****XX*X**X*X**XX**X*X*X****X*XXXX*X**X***XXXXX****XX***X*
XXX*X**X***XXXX*X****XXXXXXX*X*XXXX*XX**XXXXX*X**XX*XXX*XXXXXX***XX*X***X****XX*X*XXX**XXXXX**X*XXX*
X***X*XX*XXXX***X*XXXXX**********X***XX***X***X*XX***XX*XX*X***X*X**XXXXX*XXXX**X*****XX***XX*X*XX**
**XXX**X*XX***XXX***X*X*XXXXXXXX***X*XXXX*XX*XX**X*X**X**X*X*XXXXXX*XX*****XX**XX*XXXXX**XXXX*XXX**X
*XX*XX*XXX**XXX*XXX*X****X*****XXXXXXX****X**XXX*XXXX*XX***X***XX*X*X**XXXXX**XX**X*****XX****X***XX
*X***X**XX*XX*****X*XXXXXX*XXX*XX****X*XXXX*XX****XX***XXX*X*X******X*XX*X*X*XXXXXX*XX*XXX*XX*X*X***
***X*XX*******X*X*X**********X****XX********X**XX****X***X***XX*X*X*X******X*********X******X***X*X*