****XX*XX***XX*******X*X********X*X******XX*******************************X***X****X***X***X****X*X*
X*X**X****X****X*XX*XX***X*X*XX*****X*XX*X**X*XX*XX*XX*X*XXXX*X*XXX*XX*XX***X*X*XX*X*X***X***XX*****
**XXXX*X*XXXXXX*X*X****X**XXXX**X*X*X*X**X*XXXXX*X************X***XXX***X*X*X***XX*****X**X*XX**X*X*
*X**********X*****XX*X*XXX*****XX*****X*X*****X***XX*XX*X*XX*XXXX***XX*X*****XX**XX*XX*XX****XX***X*
X**X*X*XX*X*X*XXX**XXX**X**X*X***X*XX***XXX*XX**X**X**X******XX*XX*X***XX*XXX*XX**XXX***X*XX**XXX**X
**X************XXX***XX**X*X***X***X**X********XXX**X*XX*XX*XX***X***XXX******X*X*****X****XX***XX**
*X**X*X*XXX*XX*X*XX*X*X*X****X***X***XX*X*XXXX*X***XX**XXX**X**XXX*XXX*XXXX*X***XX*XX*XX*XX*XXX**XX*
**X***X**X***X*X*X**X****XX*X**XX*XXXX*****XX****X**XX*****XX*X*X***********X*X**X*****X*X****XX*X**
X***XXXX**XXXX*****XX*XX**X**XXX****X*XX*X*X**XX*X*XX*X*XX****X***XXX*XXX*X***XX*XXX*X*****XX**X*XX*
*XX*XX*XX**X***X*X*X**XXX*XX*****XX*X*X*XX*X*XX*****X***X**XX***XX*****X**XXXXXX****XX*XXXXXXX*X****
*******XXX***XXX*X*XX*X****X*XX*XX*****XX**X*X**X*X***X*X*X***X****XX*X**X*****X*XX***X***X**X**X*X*
*X*X*X***XXX*X***X**X***XX*********X*X****XX*XX*X***X*X***X*X*X*XX*XX*X*X*X*XX******X***X***XX*X**X*
*****X*XXX***X*X**X*X*XXX**XX*X*X*XX***XXXX***X***X*X*X*XXX*X*******X*X*XX**X*X*XXXXX*X*XX*X*****XX*
XX*XXX*****X**X**XX*X*****XX**XXX*XX*XX***XXX***X***X*********XX*XX*****X**X****X*X*X****X**X*XX**X*
***X***X*X*XX***XX**X*X*X****XXX*******XX*****X*X*X*XX*XXXXXX****XXX*XX*X*XXXX*XX*****X*XX*XX**XX*XX
*XXX*X*X*X*XX*X**X*XX*X*X*XX*XX**XX*XX****XXX*X*X*X**XXX******X*X*****X***********X*XXX****XXX**X***
***X*XX*******XX*X*X*X**X**XXX**XX**X**XX**X******XX*****XX*X*XXXX*XX*X*X*XXX*XX*XX***X*XX**XXX*X*X*
*X***X**XX*XX*X********XXX*XX**XXX*XX*X**X***X*XX*X*XX*X*X**X***X***********X*X**X**X****XX***X*****
*X*XXX*XX***XX*X*X*XXXXXX*****XXX******X*XX*X***XXX****X*XX**XX***XXX*XXX*X*X***XX*XXXXX**XX*XX*X*X*
*****X**X*X******X*X*****XXX*XX*X*XX*X********X**X**XX******X*XXX*X*XX*X****XX*XX**X*X*XX*******X*XX
XX*X*XX*****XX*X*X***XX*X*********XXXX*X*XX*X*XX***X***XX*X*X***X********XX**X*X**XX*****X*XX*X*X***
******X*X*X*XX*XX**XXX**X*X*X*X*X***XX*X*X****X**XXXX*X*XXX**X*XX*XXX*XX*XXX**X**XX**XXXX**X*****X*X
*XXXX***XX***X**X*XX***XX*X**X**XXX********XX**X********XX**X******XX**X*X*XX***X*XX***XX*XXX*X*X***
***X**X**X*X*XX****X*XXX**XX*XX***XX*XXXX*X**X**X*X*XXX**X*XXX*XXX**XX*XX****XX*X*XX*X********X***X*
*X***XXX**XX**XXXX*X*XX**X****XXX*XX*******X***XX*****XX*****XXX***XX*****XX**X******XXXXXX*X*XXXXX*
***X***XX**XX***X*XX****XXXXX*******XX*X*X**X*XX**X*X**X*XXX*X***XXX**XX*XX**X**XX*X**XX*XX****XX***
X*XXX*XX*X**XXX*X****X*XX*X***XX*X*XX*****X*X****XX*XX****X***XX*X***XXX****X*X**X*XX**X****XX**XX*X
******XX*XX***X***XXXX*X****X**XXXXX**XX*X**X*X*XXX*XXXXX*XXX***XXX*XX*XXX*XXX**XX**XX***X*XXXX**X*X
*XX*X*******X***X******X*X*X*X**X****XX***XX******X*********XXX**X**X***X******XX**XXX*XX*****XX****
**X*XXX*X*XX**X*XXXX*X**XX***XX***XX*X**X**XX*XXX*XXXX*XXXX**XXX*X*XX*X***XX*XXX**XX****XXX*X**X*X*X
X*X***X**X***XX*******X****X**XXX*X**XXX*X**X*X***XX***X*X*X********X*X*X****X***XX*X*X**XX*X*XX***X
****X***XX*XX*X*X*X*XXX*X*XXX****XXX*****XX*****XXX**X******X*XXX*XX**XX*X*XXX*XXX****XX**XXX****X**
*XX***XXX***XX**X*******X***XXXX*****X*X**XX*X*XXX**X**XX*XXX*****X**XX****XX******X*X*XX*****X*XXX*
**X*XXX***XXX**X**X*XXXXX*X**X*X*XX*X*XXX**********XXX****X***X*X*XX*X**XX****XXX*X******X*XX*****X*
X*X***XX*XX*XXXXX*X***X***XX***X****X*X*X*X*XX*XX*XX*X*XX***X*X*X*XX***X**X*X**X**XXX*X*XX*X**X*X***
****X****X***X***X*XX***XX*X*X*X*X*XX*****X**X*******X**XXXXX***X****X**X*XXXX**X*X***X*X***X*X*XXX*
X*X*X*XX*X*X***X****XXX*XX***X***X*X**XX*XXX*XXX*XX*XXX*X*****X*XXXX**XXX****XXXX***X*XXX*XX********
********X**X*X*XX*X**X*XX**X*X*X*****X***X************X*X*XXX*X*X****XX***XX***X**X*X**X**X*X*XXX*X*
XXX*X*X*XX******X**X***X**XXX****XXXX*XX***X*XXXXXX*XXX*XX*X**X*X*XX**X*XXXXXX**X*X**X**X**X**X*****
***XX*X**X*X*XX***X*XX*XX***X*XX*XX***XXX*XX*X***X**X********XX*X**X*XX*X*X*XXX***X*X*X*XX***X*XXX*X
*X****XX****XX**X***XX****X*X***XX**X***X******X***XX*X*X*X*XX**XX**X*********X*XXX***X**X*X*X*XX***
*XX*XXX**XX**X*XX*X**X*X*XX*X*X*X**X*X*XXX*X*X*XX*XX*****X**X**X**XXX*XXXXXXX******X*XXX*****X*X**X*
****XX**X**X***X**XX****XX****X***XX*X*X********X****X*X**XXX*XX*XX***X******X*XXX***X*X*X*X*****X**
X*XXX**XX*XX*X*XX**X*XX**XX*XXX*XX*****XX*X*XX*X*XX*XX*XX**XX*******X*X*XX*XX***X**X***X***X*X*X*X*X
**X***X*********X*XXXXXX**********XX*XXX*******X***XX***XX*X**XX*X*XX***XX**XXX***XX*X*XXX*****X***X
X***XX*X*X*XXXX*XX****XXX*XXX*X*X****X***XX*XX***X****X**X***XXX***X**X**XX***X*X*X**X**XXX*X*X**X**
X*X*XX***XXX*******X*XX****XX*X*XXXX***XXX*XX**XXX*X*XXXX**XXX*X*X***X*X**XXX**XX***XX*XX*X*X**XX*X*
****X**X*****XXXX*XX**XXXX*****X***XXX*X******XX***X**XX**XX*******XXX***X**XX****X*X*******XX****X*
*XX***X*XX*X*XX****XX***X*XX*XXX*X***X***X*XX****X*X*XX**XX**XXXXX*X***XXXX***XX*XXX**XX*XX*X**XX***
*XX*X**X********XX*XX*X********X*XXX***XX*****X*X****X**X***XXX***XXX*X*****XX***X*X*XXX**X*XXXX**X*
**XX*X***XX*X*XXXX***X*XXXXXXX*X**XXXX*X*X*XX*XXXXXX*XX***X*****X***X**XX*X*X**X***X***XX*X**X***XX*
X***X**X***********X********XX**X*****X**X*XX*********X*X*X*XXX**XX*XX*****X**XXXX*X*X**X**X*X*XX*X*
*XX***XX*X*X*X*X*XXXXX*X*X*X***X**X*X*XX******X*X*XXX***X****XX*X*X**XX*XX***XX****X**X**X*X***X****
**X*X*X*XX**********X******XX*X*X*X******XXX*XX*X*X*X*X**X*X**X***XX*****XX*XX**XX*X*XX*XX***X*XXX*X
X*****XX***XXX*XXX*XX*XXXX****XX***X*XX*XX*X*X**X*****XX***XX*X*X**XXX*XX***X**XXX*X*X**X**X*X***X**
**X*X****X**X**X***X*****XX*XXX**X*X*XX*****X**XX*X*X*XX*X**X*X**X***XX***X*X*XX*X***X*XX*X**XXX*XX*
X*XX*X*XXXX*X*XX*X**X*XX********XX*X***XX*X**X****X****X*XX*****X*X*X***X*XXX****XX*XX*X**XX**X***X*
***X*X******X*X**XX*XXXXX*XX*X*XX**XX*X*X***X**XX*XXXX*X*X**XXX*X***XX*X***X**XX**X*****X**XX**XX***
XX***X*X*XX*****XXX***X***X**X*X**XX******XXXXXX***X***X**X**X****X*X**XXX*X*X***XXX*XX*XX**X*XX**X*
X**X******X*XX*XX***X***XX*X***X*XX**XX*XXX***XX*X*X*X*XX*XX**X*X***X*XX*X*****X*X****X**XX****XX*X*
**XX*X*XX****X*X**XX*XX*X**X*X*XXX*X*****X**X******X****X**XX***X*X********X*XX****XXX*X*XXXXX**X*X*
*XX**X**X*XX*XX**XX*******XX******X**XXX*X*X*XXX*XXX*XX*XX**XXX*X*XXXX*X*X*****X*X*****X**XX*XX***X*
****XXX*XX**XX**X***XXXXX**X*XXXX***X*X**X**XX****XXXX***XX****X***X***X***X*X***XXXXX*XX*****X*XXX*
*X*X*X***XX*X**X*X*X**X*XX*****X*XX***XX**X****XX***XXXX**X*XX*X*X***X*XXX***XX*XX***X*XXX*XX**X****
*X***XX*XX****XX*X*XX****XXX*X*X****X*X**XX*XXXXXXX******X******XXXX***XX**X**XXXX*X*XXX***X*X***X*X
XX*X**XXX**XX*******XXX*XX*X*****X*XX***XX*X******XXXX*X*XX*X*X*X*X**X*X**X**XX****X*****X**X*X*XX**
X***X**X**XXXXXX*XX********X*XX*XX****X*X****XXXX*X*******X***X*X***XX***X*X****XXXX*XX*XXX****X*XX*
**X*XX*X*X**X*****XXX*X*X*XX***XX**X*XX*X*XX*XX*X***XX*XX***X***XX*XXXX*XX*XX*XXXX**XX****XXX*XX****
*X********XX**X*X**XX******XX*XX**X*X***X***X*X*X*XXXX*X*X*X*XXXX****X******X**X***XX**X*XX*X*X**XX*
*XXXXX*XX*X**XX*XX****XXX*XX*****X*X**X***X*X***X*X***********XX**XX*X*XX*X*X*X**X****XX********XX*X
**X******XX*X*XXX*X*X**X****X*XX*X*X*XX*XX***X*XX***XXXX*XXXX**XX*X**X**XXX*X***XXXX*XX*X*X*XXX*X***
X***XXX*X***X***X***XX**XX*X**********XX**X*X*****X*X******X*X****XXXXX**XX*X*XXX*X*XX*******XX***X*
**XXX*X***XXX*X*X*XXX*X****X*XX*XX*XX**X*XX***XX*XX***XX*X****X*X**XX*XX**X****X**X****XX*XX**X*XXX*
*XX***XX*XX*****X**X*X*X*X**XX***XXX*X******X*******X**XX*XX*XXXXX**X**XX*X*XX***XX*X*XX***XX****XX*
****X**XXXX*XXX*XX*X*****XX****X***X*XX*XX*XX*X*XXX*XX**X*******X*X*XX**X*X*X**X*X****XX*X*X*X*XXX**
*X*XXX**X***X********X*X*XX*X*XX*X***XX*X**XX*XX*X***XX***X*X*X***X****XX*****X***X*X**XXX******X**X
****X*X*X*X*X*X*XX*X*X**XX*X****XX*X**XX**XX****X**X**XXX*X*X*XXX*XX*XXX**X*XXXXX***XX***X*XX*X***XX
X*X**X**X*X*XX*XX**X*XX******XX****XX**X*X***X*X**X*X**********X**X******XX*X***XXX**XXX*X*XX*X*X*X*
**XX**X*********XX***XXXX*X*XX*X*XXX*X****X*XX***XX*X*X*XXX*XX*X*XX*XXXXX***X*X***X*X*X**X**X**XX***
X*XXX*X*X*XX*XX*X**X******XXX******X***XX***X**X**X***X*****XX*X**X**X***X*XX***X****X**XXX*XX**X*X*
**X*****X*X***X**XXX*X*X*XX***XXXX***X*XXX*X**X*X***X***XXX*X***X***XX*X***XX*X*XX*XXX*X*X****X*****
X*X*XX*XX*X*XXXX**X***XX*X**XX***X*XXX**XX*X*X*XX*X**XXXXX****X*XXX*X***XXXX***XX******X***XXXX*X*XX
***X***XX***X**X*X**X***XX*XX*X*XX***XX****X*X****X*XX***X*XX*X***XXX*XX*XX**XX***XX*XXX*X*X*XX*****
*X*X*X*X**X*XX*X***XXXX****X*****X*X**XX*X*X***X*XX*X**X*X*XX***X*XX**X*****X**X*XX**X*******X**X*X*
*X***X***X***X*XXXXX****X*XX*X*X***XX**XX*X*X*XX*X****X****X**XX*****XXX*XXX*X*X*X*X***XX*XXXX*XX*X*
*X*X*X*XX**X*******XX*X***X******X**X*X************XX*X*X*XX*X**X*X*X**********X***X*X*X************
*X**X*X***XXX*XX*X**X***X***XX*X*XX*X***X*XX*X*X*X*X***X***X**X*****XX*XXXX*XX*XXX***XX**X*X*XXX*XXX
*XX*****X**XX*X***XX**X*X*X**X*X*X**X*XX**XX******XX*X***X*XX*XXXXX*****X*X**X*X*XXX*X**X*X**X******
**XX*XX*X*XX**X*X****XX*****X**X***X**X**X***XXXX**X*XX*XX**X**XX***XXX***XX******X****X****XX*XXXX*
X*X*******X**X**XX*X*XXXX*XX**X*XXXXX*X*XXX*XX*XXX**X******XXX****X*****X*X**X*XX***XX*XXX*XX**X*XX*
****X*X*X***XX*XX**X*X*******XX*X*****X*X*X*X****XX*XXX*XX*XX**X*XXX*X*XX*XX*X**XXX*X******XX*XX**X*
X*X***X**X*X******X****XXXXX**XX**X*XXX*X*X**X*X**X***X*X***XXX********X***XXXX**XX*XXXX*X*****XX***
***XX**X***X*XX*XX*X*X*X***XXXX**XX*X***X**X***XX***X**X**X****X*X*XXX*XXX****XX****XX***X*X*X****X*
XX**XX***X*X**X***X*X**X*X**XX**XX**X*XXX*XXXX*XX*XXXX***XX*XX*XXX*****X*X*X*XXX*X*X***XXX*XX*XX*XX*
*XX**XXX*X*XX*X*X*****XX*XX**X*XXX*XX***X*X**X******X*XX*XXXX******XXXXX*XX***X**X**X*X*X***XX***X**
***X*******X***XX*XX*XX***XX********XX*X****XXX*X*X****X****XXX*XX*X********X***X*X*****X*XXX**X*XX*
*XX*XX*X*X***X**X*X*****X**X*X*X*XXX*****XX*X*X***X*X*XX*XX**X*****X*X*X*XXX*X*XX***XXX*X*****XX*X**
****XX*****X*XX*X**X*XXXXXX**X***X***XXXXXX*X*X*X**X**X***XX*XXXX*X*X***XX***XX***XXXX**X*X*XXX**X*X
*XX**XX*X*XX*X*XXX*X*X***X**XX*X*X*X*X***X******XX*X*XX*XX*X*XX****X**X*X**X*X**X**X***X***X****XX**
**XX*******************X***XX**X***X***X***XX*X****X************XX***XX***XX***X*X***X**XX***XX***X*