***X**********************************************
XX*XXXXXXXXXXXXXXXXXXXXXXXXXXXXXXXXXXXXXXXXXXXXXX*
*X**********************************************X*
*X**********************************************X*
*X**********************************************X*
*X**********************************************X*
*X**********************************************X*
*X**********************************************X*
*X**********************************************X*
*X**********************************************X*
*X**********************************************X*
*X**********************************************X*
*X**********************************************X*
*X**********************************************X*
*X**********************************************X*
*X**********************************************X*
*X**********************************************X*
*X**********************************************X*
*X**********************************************X*
*X**********************************************X*
*X**********************************************X*
*X**********************************************X*
*X**********************************************X*
*X**********************************************X*
*X**********************************************X*
*X**********************************************X*
*X**********************************************X*
*X**********************************************X*
*X**********************************************X*
*X**********************************************X*
*X**********************************************X*
*X**********************************************X*
*X**********************************************X*
*X**********************************************X*
*X**********************************************X*
*X**********************************************X*
*X**********************************************X*
*X**********************************************X*
*X**********************************************X*
*X**********************************************X*
*X**********************************************X*
*X**********************************************X*
*X**********************************************X*
*X**********************************************X*
*X**********************************************X*
*X**********************************************X*
*X**********************************************X*
*X************************************************
*XXXXXXXXXXXXXXXXXXXXXXXXXXXXXXXXXXXXXXXXXXXXXXXX*
**************************************************