**X**X***X***X****X*****XX**************XX**X**XX***********X*XX*****XX*X*X******X***X*****XX*X****X
X*XX***X***X***XX*X*XXX**XXXXXXXXXX*XXX**XX***XX**XXXXXXX*X***X**X*X**X*****X*XX*X*X***XX*XX****XX**
**X**XXXX*XXXXXXX*X***XX**XX******X**XXX*XX*X****XX*****X*X*X***XXXXX*X*XXXXX*XX*XXXX*XX***X*XXXXXX*
*XXX*XX***X*****X*XXX*XXX**X*XXXX*XX*X*X**XXX*XXXXXX*XX*X*X*XXXXX*XX**X**X****X***X***XX*X*X*X***XX*
**X**X**XXX*X*X***X***X*XX***X**X****X*XX**X***X*XX**X**X*X*X***X*X**XXXXX*XXXXXX*X*X**XXX***X*X*X**
X*XXXX*XX*X*XXXXXXXX*XX**XXXXX*XXXXXXX**XX*X*X***X**XXX*XXX*XXX*X***XX*X***X**X***X*XX**XXXX*X*XXX*X
**XX***X*****XX****X*X**XXX****XX******XXX*XXXXXXX*XX*****X**XX*X*XXX****XXXX***XXX**XX***XXXX******
*XX**XXX*XXX**X*XX***XX***XX*X**XXX*XX*****X*****X**XXX*X*XX**X*X**XXXX*XX****XXX*XXXX**X****X*XXXXX
****XX*X*X*XX*X*XXXXXXX*X*X**XX**X***XXXXX*X*X*X*XX*XX**X*XXX*X*XX***X**X**XX*XX*****XXXXXXX*X****X*
X*X*X*******X***X*******X***XXXX***X*****X***X*X****X**XX*****X****X***XX*XXX****X*X*********XX*X***