**X*******XX****X****X***X********X****X****X*X***
X*XXXXX*X*X**XX*X*XX***X***XXXXX*XX*X*XX*X*XX***X*
****X***X*X*XXX****X*X*XXXXX***X*X**X****X****X*X*
XXX***XXX*X***X*XXXXXXXXX****X*X*X*XXXXXXXXXXXXXX*
**XXXXX***XXXXX****XX*****XXXX*X*X**X******X***XX*
X***XX**XXX***XXXXXX**XXXXXX***X*XX*XXXX*X***XXX**
**X*X**XX***X**XX****XXX*****X*X*****X***XXXXXX**X
*XXXX*XXXXX*XX****XXXXX**XXXXXXXXXXX*X*XXX***X**XX
***XX**XX***XXXXXXX***X*XX***XX***XX***XX**X***XX*
*X**X*XX**XXX****XXXX***X**X****X**XXXXX**XXXX**X*
*XX*X*X**XX***XX**XX**XXXX*XXXX*XX*****X*XX*XXX*X*
**X*X***XX**XXXXX*X**XX**X***X**XX*XXX***X***X****
*XX*XXXXX**XXX**X***XXXX***X*XXXX***XXXXXX*X***XXX
XX**X***X*XX*X*XXXXXX*X**XXX***X**X**X***XXX*XXX*X
***XX*X*X*X**X********XXXXX**X*XX*XX*X*X**X**XX***
X*XX**X***XX***XXX*XX*****XXXX**X**XXX*XX*X*XX**X*
**X**XXXXXX**XXXX**XXXXXX***XXX*XX*XX**X**X**XXXX*
*XX*XXX***X*XXX***XX***XXXX**X**XXXX**XX*XXX***X**
*X**X***XXX**X**XXXXXX****XX***XX****XX**X***X*X*X
***XX*X**X**XX*XX**XX**XX****X*XX*XXXX**XX*XXX*X**
*XXX**XXXX*XX**X**XX**XX**X*XXXX***XX**XXXXXX**XX*
***XX*XX****X*XX*XX**XXX*XXXXX***XXX**XX***X**XXX*
XX**X****XX*X*X**X**XX****XX***XXX***XX**X*XX***X*
*XX*X*XXXXXXX*X*XX*XXXXXXXX**XXX*X*XXXX*XX**XXX*X*
****X*XX*X*X**X**X*X*X***X**XX*X*X*******XX***X***
*XXXX**X*X***XXX*X*X*X*X***XX****X*XXXXXXXXXX*XXX*
*XX*XX***X*XXX*******X*XXXXX**XX*XXX*****XX*X**X**
**X**XXX*X*XX**XXXXX*X**X**XXXXX**X**X*X**X*XX*XXX
X*XX***X*X**X*XX***X*XX*XX*****XX***XXXXX***XX****
**X**X*X*XX*X*XX*X*X*XX****XXX**XXX**XX***X**XXX*X
*XXX*X***X**XXX**X*X**XXXXXX*XX***XX**X*XXXX**XX**
***XXX*XXX*XXX**XX*XXXXX*X****XXX*XXX*X****XX**XX*
XX***X*X*****X*XXX*****X*X*XX******XX*XX*XXXXX**X*
*XXX*XXX*X*XXX*X*XXXXX*****XXXXX*X****X***XXXXXXX*
*****X***XXX***X****XXXXXXXX*X*XXXXXXXX*X**XX*****
*XXXXXX*XXX**XXX*XX**X*X*X*****X*****XXXXX**XXX*XX
*XX***X*X***XX*X*XXX*****XX*XXXX*XXX*X***XXXX****X
**X*X***X*XXXX*****XX*XX*X***X***X*****X******XX**
X*XXXXX***X****X*X*X**X**X*X*X*XXXXXXXXXXXXXXXXX*X
**X***X*XXXX*XXX*XXX*XXX***X*X*XX*****X*****XX*X**
*XX*X*X**XX***XX**X**X*XXXXX*X****XXX*XX*X*XX**XX*
**X*X*XX**XXX**XXXX*XX*X***X*XXXXXXX**X**X****XX**
X***X*XXX**XXX**XX**XX***X*****X***X*XX*XX*XXXX**X
XXX*X***XX*X*XXXX**XX**XXXXXXX***X*X*X**X**X****XX
**XXXXX**X****XX**XX**XXX****XXX*X*X*X*XXXXX*XXXXX
X**XX*XX*XXXX****XX**XXX**XX**XX*XXX*X*******X****
XX*****X***XXXXXXX**XX***XXXX**X*XX**X*XXXXXXX*XX*
*XX*XXXXXX**X***X**XX**X****XX*X**X*XX**X**X*X*X**
****X****XX***X*XXXX**XXX*X**X*XXXX**XX*XX***X*XX*
*XX***XX****X*X******XX***XX*X******XXX****X****X*