***XX***XX
*X**XXX***
XXX**X**X*
X*XX***XX*
***XXXXXX*
*X*****X**
*XX*XXXX*X
**XXX*****
X**XX*XXX
XX******X*