*XX******X
**XXX*XX**
X**XX**XXX
XX**XX***X
*XX*X**X**
*XX*XX*XX*
*X***X*XX*
*X*X*X**X*
***X*XXXX*
*X*X******